Ethnicity	Ethnic Group
Aceh	Asian, Middle East and Tribes
Afghans in India	Asian, Middle East and Tribes
Agrawal	Asian, Middle East and Tribes
Asian people	Asian, Middle East and Tribes
Bengali Brahmins	Asian, Middle East and Tribes
Bengali Hindus	Asian, Middle East and Tribes
Bengali people	Asian, Middle East and Tribes
Bhutia	Asian, Middle East and Tribes
Bihari people	Asian, Middle East and Tribes
Brahmin caste	Asian, Middle East and Tribes
Bunt	Asian, Middle East and Tribes
Buryats	Asian, Middle East and Tribes
Chaliyan	Asian, Middle East and Tribes
Chettiar	Asian, Middle East and Tribes
Chinese Filipino	Asian, Middle East and Tribes
Chinese Indonesians	Asian, Middle East and Tribes
Chinese Singaporeans	Asian, Middle East and Tribes
Chitrapur Saraswat Brahmin	Asian, Middle East and Tribes
Dalit	Asian, Middle East and Tribes
Dogra	Asian, Middle East and Tribes
Ezhava	Asian, Middle East and Tribes
Filipino people	Asian, Middle East and Tribes
Filipino people of Spanish ancestry	Asian, Middle East and Tribes
Gaud Saraswat Brahmin	Asian, Middle East and Tribes
Gin people	Asian, Middle East and Tribes
Goans	Asian, Middle East and Tribes
Gujarati people	Asian, Middle East and Tribes
Han Chinese people	Asian, Middle East and Tribes
Hazaras	Asian, Middle East and Tribes
Hindkowans	Asian, Middle East and Tribes
Hindu	Asian, Middle East and Tribes
Hongkongers	Asian, Middle East and Tribes
Ilocano	Asian, Middle East and Tribes
Indian diaspora	Asian, Middle East and Tribes
Indian diaspora in France	Asian, Middle East and Tribes
Indians	Asian, Middle East and Tribes
Jaat	Asian, Middle East and Tribes
Japanese people	Asian, Middle East and Tribes
Jatt Sikh	Asian, Middle East and Tribes
Javanese	Asian, Middle East and Tribes
Kannada people	Asian, Middle East and Tribes
Kanyakubja Brahmins	Asian, Middle East and Tribes
Kapampangan people	Asian, Middle East and Tribes
Karnataka Brahmins	Asian, Middle East and Tribes
Kashmiri Pandit	Asian, Middle East and Tribes
Kashmiri people	Asian, Middle East and Tribes
Kayastha	Asian, Middle East and Tribes
Khatri	Asian, Middle East and Tribes
Konkani people	Asian, Middle East and Tribes
Koreans	Asian, Middle East and Tribes
Lao people	Asian, Middle East and Tribes
Malayali	Asian, Middle East and Tribes
Malaysian Chinese	Asian, Middle East and Tribes
Manchu	Asian, Middle East and Tribes
Marathi people	Asian, Middle East and Tribes
Marwari people	Asian, Middle East and Tribes
Mohyal	Asian, Middle East and Tribes
Mudaliar	Asian, Middle East and Tribes
Muhajir	Asian, Middle East and Tribes
Nair	Asian, Middle East and Tribes
Niyogi	Asian, Middle East and Tribes
Pakistanis	Asian, Middle East and Tribes
Parsi	Asian, Middle East and Tribes
Punjabi diaspora	Asian, Middle East and Tribes
Punjabis	Asian, Middle East and Tribes
Rohilla	Asian, Middle East and Tribes
Romani people	Asian, Middle East and Tribes
Romani people in Spain	Asian, Middle East and Tribes
Ryukyuan people	Asian, Middle East and Tribes
Sherpa	Asian, Middle East and Tribes
Sikh	Asian, Middle East and Tribes
Sindhis	Asian, Middle East and Tribes
Sinhalese	Asian, Middle East and Tribes
Sri Lankan Tamil diaspora	Asian, Middle East and Tribes
Sri Lankan Tamils	Asian, Middle East and Tribes
Taiwanese	Asian, Middle East and Tribes
Tamil	Asian, Middle East and Tribes
Tamil Brahmin	Asian, Middle East and Tribes
Telugu Brahmins	Asian, Middle East and Tribes
Telugu people	Asian, Middle East and Tribes
Thai Chinese people	Asian, Middle East and Tribes
Thai people	Asian, Middle East and Tribes
Tibetan people	Asian, Middle East and Tribes
Tulu people	Asian, Middle East and Tribes
Vietnamese people	Asian, Middle East and Tribes
Zhuang people	Asian, Middle East and Tribes
rajput	Asian, Middle East and Tribes
African Americans	Black, Caribbean or African
Aboriginal Australians	Black, Caribbean or African
African people	Black, Caribbean or African
Afro Trinidadians and Tobagonians	Black, Caribbean or African
Akan people	Black, Caribbean or African
Black British	Black, Caribbean or African
Black Canadians	Black, Caribbean or African
Black Hispanic and Latino Americans	Black, Caribbean or African
Black Irish	Black, Caribbean or African
Black people	Black, Caribbean or African
Cubans	Black, Caribbean or African
Dinka people	Black, Caribbean or African
Ghanaians	Black, Caribbean or African
Indigenous Australians	Black, Caribbean or African
Kikuyu	Black, Caribbean or African
Mandinka people	Black, Caribbean or African
Sierra Leone Creole people	Black, Caribbean or African
Sierra Leoneans in the United Kingdom	Black, Caribbean or African
Somalis	Black, Caribbean or African
Wolof people	Black, Caribbean or African
Xhosa people	Black, Caribbean or African
Yoruba people	Black, Caribbean or African
Acadians	White
Afrikaners	White
Albanians	White
American Jews	White
Americans	White
Anglo-Irish people	White
Argentines	White
Ashkenazi Jews	White
Australian American	White
Australians	White
Austrians	White
Austrians in the United Kingdom	White
Basque people	White
Belarusians	White
Belgians	White
Bosniaks	White
Bosnians	White
Brazilians	White
British Americans	White
British Jews	White
British people	White
Bulgarians	White
Cajun	White
Canadian Americans	White
Canadian Australian	White
Canadians in the United Kingdom	White
Castilians	White
Catalan people	White
Chileans	White
Chileans in the United Kingdom	White
Colombians	White
Corsicans	White
Criollo people	White
Croats	White
Czechs	White
Dalmatian Italians	White
Danes	White
Dene	White
Dutch	White
English Americans	White
English Australian	White
English Canadians	White
English people	White
Estonians	White
Finns	White
French	White
French Canadians	White
French-speaking Quebecer	White
Galicians	White
Georgians	White
Germans	White
Gibraltarian people	White
Greek Cypriots	White
Greeks in South Africa	White
Greeks in the United Kingdom	White
Hispanic	White
Hispanic and Latino Americans	White
Hondurans	White
Hungarians	White
Hutsuls	White
Icelanders	White
Irish Americans	White
Irish Australian	White
Irish Canadians	White
Irish migration to Great Britain	White
Irish people	White
Israeli Jews	White
Israelis	White
Italian immigration to Mexico	White
Italians	White
Italians in the United Kingdom	White
Kiwi	White
Latin American migration to the United Kingdom	White
Latino	White
Latvians	White
Lebanese	White
Lebanese immigration to Mexico	White
Lebanese people in the United Kingdom	White
Lithuanian Jews	White
Manx people	White
Mexicans	White
Norwegians	White
Peruvians in the United Kingdom	White
Poles	White
Poles in the United Kingdom	White
Portuguese	White
Quebeckers	White
Romanians	White
Romanichal	White
Russians	White
Scotch-Irish Americans	White
Scottish American	White
Scottish Australian	White
Scottish Canadians	White
Scottish people	White
Sephardi Jews	White
Serbs in North Macedonia	White
Serbs in the United Kingdom	White
Serbs of Bosnia and Herzegovina	White
Serbs of Croatia	White
Slavs	White
Slovaks	White
Slovenes	White
Soviet people	White
Spaniards	White
Spanish immigration to Mexico	White
Spanish people of Filipino ancestry	White
Swedes	White
Swedish-speaking population of Finland	White
Swiss	White
Sámi peoples	White
Tatars	White
Tejano	White
Transylvanian Saxons	White
Ukrainians	White
Uruguayans	White
Venezuelans	White
Welsh American	White
Welsh people	White
White Africans of European ancestry	White
White Americans	White
White British	White
White Latin American	White
White South Africans	White
Yugoslavs	White
white people	White
Afro-Asians	Mixed or multiple ethnic groups
Afro-Cuban	Mixed or multiple ethnic groups
Afro-Guyanese	Mixed or multiple ethnic groups
Albanian American	Mixed or multiple ethnic groups
Anglo-Celtic Australians	Mixed or multiple ethnic groups
Anglo-Indian people	Mixed or multiple ethnic groups
Arab Americans	Mixed or multiple ethnic groups
Arab Mexican	Mixed or multiple ethnic groups
Armenian American	Mixed or multiple ethnic groups
Aromanians	Mixed or multiple ethnic groups
Asian Americans	Mixed or multiple ethnic groups
Austrian Americans	Mixed or multiple ethnic groups
Bahamian Americans	Mixed or multiple ethnic groups
Baltic Russians	Mixed or multiple ethnic groups
Bangladeshi American	Mixed or multiple ethnic groups
Barbadian American	Mixed or multiple ethnic groups
Bolivian American	Mixed or multiple ethnic groups
Brazilian Americans	Mixed or multiple ethnic groups
British African Caribbean people	Mixed or multiple ethnic groups
British Asian	Mixed or multiple ethnic groups
British Chinese	Mixed or multiple ethnic groups
British Indian people	Mixed or multiple ethnic groups
British Jamaican	Mixed or multiple ethnic groups
British Nigerian	Mixed or multiple ethnic groups
British Pakistanis	Mixed or multiple ethnic groups
Bulgarian Canadians	Mixed or multiple ethnic groups
Burmese Americans	Mixed or multiple ethnic groups
Cambodian Americans	Mixed or multiple ethnic groups
Chilean American	Mixed or multiple ethnic groups
Chinese Americans	Mixed or multiple ethnic groups
Chinese Canadians	Mixed or multiple ethnic groups
Chinese Jamaicans	Mixed or multiple ethnic groups
Colombian Americans	Mixed or multiple ethnic groups
Colombian Australian	Mixed or multiple ethnic groups
Croatian Americans	Mixed or multiple ethnic groups
Croatian Australians	Mixed or multiple ethnic groups
Croatian Canadians	Mixed or multiple ethnic groups
Cuban American	Mixed or multiple ethnic groups
Czech Americans	Mixed or multiple ethnic groups
Czech Australians	Mixed or multiple ethnic groups
Danish Americans	Mixed or multiple ethnic groups
Danish Canadians	Mixed or multiple ethnic groups
Dominican Americans	Mixed or multiple ethnic groups
Dutch Americans	Mixed or multiple ethnic groups
Dutch Australian	Mixed or multiple ethnic groups
Dutch Canadians	Mixed or multiple ethnic groups
Ecuadorian Americans	Mixed or multiple ethnic groups
Eurasian	Mixed or multiple ethnic groups
European Americans	Mixed or multiple ethnic groups
Filipino Americans	Mixed or multiple ethnic groups
Filipino Australians	Mixed or multiple ethnic groups
Filipino mestizo	Mixed or multiple ethnic groups
Finnish Americans	Mixed or multiple ethnic groups
French Americans	Mixed or multiple ethnic groups
French Chilean	Mixed or multiple ethnic groups
German Americans	Mixed or multiple ethnic groups
German Brazilians	Mixed or multiple ethnic groups
German Canadians	Mixed or multiple ethnic groups
Ghanaian American	Mixed or multiple ethnic groups
Greek American	Mixed or multiple ethnic groups
Greek Australian	Mixed or multiple ethnic groups
Greek Canadians	Mixed or multiple ethnic groups
Guyanese American	Mixed or multiple ethnic groups
Haitian American	Mixed or multiple ethnic groups
Hmong American	Mixed or multiple ethnic groups
Honduran Americans	Mixed or multiple ethnic groups
Hungarian Americans	Mixed or multiple ethnic groups
Indian Americans	Mixed or multiple ethnic groups
Indian Australian	Mixed or multiple ethnic groups
Indo Caribbeans	Mixed or multiple ethnic groups
Indo-Canadians	Mixed or multiple ethnic groups
Indo-Guyanese	Mixed or multiple ethnic groups
Indonesian Americans	Mixed or multiple ethnic groups
Iranian Americans	Mixed or multiple ethnic groups
Iranian Canadians	Mixed or multiple ethnic groups
Iraqi Americans	Mixed or multiple ethnic groups
Israeli Americans	Mixed or multiple ethnic groups
Italian Americans	Mixed or multiple ethnic groups
Italian Australian	Mixed or multiple ethnic groups
Italian Brazilians	Mixed or multiple ethnic groups
Italian Canadians	Mixed or multiple ethnic groups
Japanese Americans	Mixed or multiple ethnic groups
Japanese Brazilians	Mixed or multiple ethnic groups
Korean American	Mixed or multiple ethnic groups
Koryo-saram	Mixed or multiple ethnic groups
Latvian American	Mixed or multiple ethnic groups
Lebanese Americans	Mixed or multiple ethnic groups
Lithuanian American	Mixed or multiple ethnic groups
Louisiana Creole people	Mixed or multiple ethnic groups
Lumbee	Mixed or multiple ethnic groups
Luxembourgish Americans	Mixed or multiple ethnic groups
Malagasy people	Mixed or multiple ethnic groups
Mangaloreans	Mixed or multiple ethnic groups
Mexican Americans	Mixed or multiple ethnic groups
Moroccan Americans	Mixed or multiple ethnic groups
Multiracial American	Mixed or multiple ethnic groups
Métis	Mixed or multiple ethnic groups
Nepali Indian	Mixed or multiple ethnic groups
Nigerian American	Mixed or multiple ethnic groups
Norwegian Americans	Mixed or multiple ethnic groups
Pacific Islander Americans	Mixed or multiple ethnic groups
Pakistani American	Mixed or multiple ethnic groups
Pakistani Canadians	Mixed or multiple ethnic groups
Palestinian American	Mixed or multiple ethnic groups
Panamanian American	Mixed or multiple ethnic groups
Persians	Mixed or multiple ethnic groups
Polish Americans	Mixed or multiple ethnic groups
Polish Australian	Mixed or multiple ethnic groups
Polish Canadians	Mixed or multiple ethnic groups
Portuguese Americans	Mixed or multiple ethnic groups
Puerto Ricans	Mixed or multiple ethnic groups
Romanian Americans	Mixed or multiple ethnic groups
Russian Americans	Mixed or multiple ethnic groups
Russian Canadians	Mixed or multiple ethnic groups
Rusyn American	Mixed or multiple ethnic groups
Salvadoran Americans	Mixed or multiple ethnic groups
Samoan American	Mixed or multiple ethnic groups
Samoan New Zealanders	Mixed or multiple ethnic groups
Scandinavian Americans	Mixed or multiple ethnic groups
Serbian Americans	Mixed or multiple ethnic groups
Serbian Australian	Mixed or multiple ethnic groups
Serbian Canadians	Mixed or multiple ethnic groups
Sicilian Americans	Mixed or multiple ethnic groups
Slovak Americans	Mixed or multiple ethnic groups
Slovene American	Mixed or multiple ethnic groups
South African American	Mixed or multiple ethnic groups
Spanish American	Mixed or multiple ethnic groups
Sri Lankan Americans	Mixed or multiple ethnic groups
Stateside Puerto Ricans	Mixed or multiple ethnic groups
Sudanese Australians	Mixed or multiple ethnic groups
Swedish Americans	Mixed or multiple ethnic groups
Swedish Australian	Mixed or multiple ethnic groups
Swedish Canadians	Mixed or multiple ethnic groups
Syrian Americans	Mixed or multiple ethnic groups
Taiwanese Americans	Mixed or multiple ethnic groups
Tamil Americans	Mixed or multiple ethnic groups
Thai Americans	Mixed or multiple ethnic groups
Turkish Americans	Mixed or multiple ethnic groups
Ukrainian Americans	Mixed or multiple ethnic groups
Ukrainian Canadians	Mixed or multiple ethnic groups
Venezuelan Americans	Mixed or multiple ethnic groups
Vietnamese Americans	Mixed or multiple ethnic groups
Welsh Italians	Mixed or multiple ethnic groups
multiracial people	Mixed or multiple ethnic groups
peoples of the Caucasus	Mixed or multiple ethnic groups
Apache	Asian, Middle East and Tribes
Arabs	Asian, Middle East and Tribes
Arabs in Bulgaria	Asian, Middle East and Tribes
Armenians	Asian, Middle East and Tribes
Armenians in Italy	Asian, Middle East and Tribes
Armenians of Russia	Asian, Middle East and Tribes
Assyrian people	Asian, Middle East and Tribes
Aymara	Asian, Middle East and Tribes
Azerbaijanis	Asian, Middle East and Tribes
Berber	Asian, Middle East and Tribes
Blackfoot Confederacy	Asian, Middle East and Tribes
Bohemian	Asian, Middle East and Tribes
Cherokee	Asian, Middle East and Tribes
Cheyennes	Asian, Middle East and Tribes
Choctaw	Asian, Middle East and Tribes
Copts	Asian, Middle East and Tribes
Cree	Asian, Middle East and Tribes
Egyptians	Asian, Middle East and Tribes
First Nations	Asian, Middle East and Tribes
Haudenosaunee	Asian, Middle East and Tribes
History of the Jews in Morocco	Asian, Middle East and Tribes
Ho-Chunk	Asian, Middle East and Tribes
Indigenous peoples of the Americas	Asian, Middle East and Tribes
Inuit	Asian, Middle East and Tribes
Inupiat people	Asian, Middle East and Tribes
Iranians	Asian, Middle East and Tribes
Iranians in the United Kingdom	Asian, Middle East and Tribes
Jewish people	Asian, Middle East and Tribes
Kabyle people	Asian, Middle East and Tribes
Kurds	Asian, Middle East and Tribes
Mizrahi Jews	Asian, Middle East and Tribes
Mohawk people	Asian, Middle East and Tribes
Moroccans	Asian, Middle East and Tribes
Muslim	Asian, Middle East and Tribes
Māori	Asian, Middle East and Tribes
Native Americans in the United States	Asian, Middle East and Tribes
Native Hawaiians	Asian, Middle East and Tribes
Nez Perce	Asian, Middle East and Tribes
Ojibwe	Asian, Middle East and Tribes
Omaha people	Asian, Middle East and Tribes
Oneida	Asian, Middle East and Tribes
Ossetians	Asian, Middle East and Tribes
Pashtuns	Asian, Middle East and Tribes
Pathani	Asian, Middle East and Tribes
Sioux	Asian, Middle East and Tribes
Sudanese Arabs	Asian, Middle East and Tribes
culture of Palestine	Asian, Middle East and Tribes
demographics of Iraq	Asian, Middle East and Tribes
history of the Jews in India	Asian, Middle East and Tribes
history of the Jews in the African diaspora	Asian, Middle East and Tribes
names of the Greeks	Asian, Middle East and Tribes
